pelotón       |pelotón
fusilamiento  |fusilamiento
remota        |remoto
cañabrava     |cañabrava
diáfanas      |diáfano
lecho         |lecho
pulidas       |pulido
carecían      |carecer
desarrapados  |desarrapado
carpa         |carpa
alboroto      |alboroto
pitos         |pito
timbales      |timbal
Primero       |primero
montaraz      |montaraz
gorrión       |gorrión
truculenta    |truculento
octava        |octavo
maravilla     |maravilla
sabios        |sabio
lingotes      |lingote
espantó       |espantarse
calderos      |caldero
pailas        |paila
tenazas       |tenazas
anafes        |anafe
crujían       |crujir
tornillos     |tornillo
desenclavarse |desenclavarse
arrastraban   |arrastrarse
desbandada    |desbandada
turbulenta    |turbulento
pregonaba     |pregonar
acento        |acento
desaforada    |desaforado
ingenio       |ingenio
milagro       |milagro
desentrañar   |desentrañar
honrado       |honrado
previno       |prevenir
mulo          |mulo
partida       |partida
chivos        |chivo
imantados     |imantar
ensanchar     |ensanchar
desmedrado    |desmedrado
patrimonio    |patrimonio
disuadirlo    |disuadir
sobrarnos     |sobrar
empedrar      |empedrar
empeñó        |empeñarse
acierto       |acierto
conjeturas    |conjetura
palmo         |palmo
inclusive     |inclusive
conjuro       |conjuro
desenterrar   |desenterrar
armadura      |armadura
soldadas      |soldado
cascote       |cascote
óxido         |óxido
resonancia    |resonancia
hueca         |hueco
calabazo      |calabazo
desarticular  |desarticular
esqueleto     |esqueleto
calcificado   |calcificado
colgado       |colgar
relicario     |relicario
cobre         |cobre
rizo          |rizo
catalejo      |catalejo
lupa          |lupa
tambor        |tambor
judíos        |judío
Mediante      |mediante
asomaba       |asomarse
asombrosa     |asombroso
montón        |montón
consternación |consternación
cofre         |cofre
privaciones   |privación
enterrado     |enterrar
tácticos      |táctico
abnegación    |abnegación
expuso        |exponerse
quemaduras    |quemadura
úlceras       |úlcera
sanar         |sanar
inventiva     |inventiva
novedosa      |novedoso
didáctica     |didáctico