2.Приветствия. Прощания. Извинения.Благодарность
Здравствуй!	你好!
Здравствуйте!	你们好!
Доброе утро!	早上好!
Добрый день!	午安!
Добрый вечер!	晚上好!

здороваться	问好
Привет!	你好!
привет, приветствие	问候
приветствовать	欢迎
Как дела?	你好吗?
Что нового?	有什么新消息?

До свидания!	再见!
До скорой встречи!	回头见!
Прощай! Прощайте!	再见!
прощаться	说再见
Пока!	回头见!

Спасибо!	谢谢!
Большое спасибо!	多谢!
Пожалуйста (ответ)	不客气
Не стоит благодарности	不用谢谢!
Не за что	没什么

Извини! Извините!	请原谅
извиняться	道歉
Мои извинения.	我道次
Простите!	对不起!
прощать (кого-л.)	原谅
пожалуйста (при просьбе)	请

Не забудьте!	别忘了!
Конечно!	当然!
Конечно нет!	当然不是!
Согласен!	同意!
Хватит!	够了!
