antojo        | antojo        | Por la noche leía en la cama hasta tarde, mientras Hedwig entraba y salía a su antojo por la ventana abierta.
desplazamiento| desplazamiento| El último día de agosto pensó que era mejor hablar con sus tíos sobre el desplazamiento a la estación de King’s Cross al día siguiente.
alfombras     | alfombra      | ¿Las alfombras mágicas estarán todas rotas?
tejanos       | tejanos       | Se levantó y se puso los tejanos: no quería andar por la estación con su túnica de mago, ya se cambiaría en el tren.
perversa      | perverso      | Harry pensó que era una rara amabilidad, hasta que tío Vernon se detuvo en seco, mirando los andenes con una sonrisa perversa.
taquilla      | taquilla      | Se preguntó si debería sacar su varita y comenzar a golpear la taquilla, entre los andenes nueve y diez.
pelirroja     | pelirrojo     | —¡Nueve y tres cuartos! —dijo la voz aguda de una niña, también pelirroja, que iba de la mano de la mujer—.
quieta        | quieto        | Ahora estate quieta.
pecoso        | pecoso        | Era alto, flacucho y pecoso, con manos y pies grandes y una larga nariz.
desvió        | desviar       | Lanzó una mirada a Harry y luego desvió la vista rápidamente hacia la ventanilla, como si no hubiera estado observándolo.
listón        | listón        | Podría decirse que tengo el listón muy alto.
revoltosos    | revoltoso     | Fred y George son muy revoltosos, pero a pesar de eso sacan muy buenas notas y todos los consideran muy divertidos.
enrojecieron  | enrojecer     | Las orejas de Ron enrojecieron.
traqueteo     | traqueteo     | A eso de las doce y media se produjo un traqueteo en el pasillo, y una mujer de cara sonriente, con hoyuelos, se asomó y les dijo: —¿Queréis algo del carrito, guapos?
hoyuelos      | hoyuelo       | A eso de las doce y media se produjo un traqueteo en el pasillo, y una mujer de cara sonriente, con hoyuelos, se asomó y les dijo: —¿Queréis algo del carrito, guapos?
golosinas     | golosina      | Cuando vivía con los Dursley nunca había tenido dinero para comprarse golosinas y, puesto que tenía los bolsillos repletos de monedas de oro, plata y bronce, estaba listo para comprarse todas las barras de chocolate que pudiera llevar.
chicles       | chicle        | En cambio, tenía Grageas Bertie Bott de Todos los Sabores, chicles, ranas de chocolate, empanada de calabaza, pasteles en forma de caldero, varitas de regaliz y otra cantidad de cosas extrañas que Harry no había visto en su vida.
empanada      | empanada      | En cambio, tenía Grageas Bertie Bott de Todos los Sabores, chicles, ranas de chocolate, empanada de calabaza, pasteles en forma de caldero, varitas de regaliz y otra cantidad de cosas extrañas que Harry no había visto en su vida.
regaliz       | regaliz       | En cambio, tenía Grageas Bertie Bott de Todos los Sabores, chicles, ranas de chocolate, empanada de calabaza, pasteles en forma de caldero, varitas de regaliz y otra cantidad de cosas extrañas que Harry no había visto en su vida.
mordisco      | mordisco      | Muchísima —dijo Harry, dando un mordisco a una empanada de calabaza.
envase        | envase        | —¿Qué son éstos? —preguntó Harry a Ron, cogiendo un envase de ranas de chocolate—.
cromo         | cromo         | Pero mira qué cromo tiene.
suelto        | suelto        | Llevaba gafas de media luna, tenía la nariz larga y encorvada, cabello plateado suelto, barba y bigote.
grageas       | gragea        | Hasta que finalmente apartó la vista de la druida Cliodna, que se rascaba la nariz, para abrir una bolsa de grageas de todos los sabores.
callos        | callos        | Ya sabes, tienes todos los comunes, como chocolate, menta y naranja, pero también puedes encontrar espinacas, hígado y callos.
Coles         | col           | Coles.
judías        | judía         | Harry encontró tostadas, coco, judías cocidas, fresa, curry, hierbas, café y sardinas, y fue lo bastante valiente para morder la punta de una gris, que Ron no quiso tocar y resultó ser pimienta.
agreste       | agreste       | En aquel momento, el paisaje que se veía por la ventanilla se hacía más agreste.
gimió         | gemir         | Cuando los dos negaron con la cabeza, gimió.
astillada     | astillar      | En algunas partes estaba astillada y, en la punta, brillaba algo blanco.
mandona       | mandón        | Tenía voz de mandona, mucho pelo color castaño y los dientes de delante bastante largos.
aturdido      | aturdido      | Harry miró a Ron y se calmó al ver en su rostro aturdido que él tampoco se había aprendido todos los libros de memoria.
abrumado      | abrumado      | Se echó hacia atrás en el asiento, con aspecto abrumado.
enteraste     | enterarse     | ¿Te enteraste de lo que pasó en Gringotts?
punzada       | punzada       | Había comenzado a sentir una punzada de miedo cada vez que mencionaban a Quien-tú-sabes.
pecas         | peca          | Mi padre me dijo que todos los Weasley son pelirrojos, con pecas y más hijos de los que pueden mantener.
indebida      | indebido      | No querrás hacerte amigo de los de la clase indebida.
gentuza       | gentuza       | Tú sigue con gentuza como los Weasley y ese Hagrid y terminarás como ellos.
desprenderse  | desprenderse  | Crabbe y Malfoy retrocedieron mientras Goyle agitaba la mano para desprenderse de la rata, gritando de dolor, hasta que, finalmente, Scabbers salió volando, chocó contra la ventanilla y los tres muchachos desaparecieron.
chiquilladas  | chiquillada   | Muy bien... He venido porque fuera están haciendo chiquilladas y corriendo por los pasillos —dijo Hermione en tono despectivo—.
retumbó       | retumbar      | Una voz retumbó en el tren.
rebosaba      | rebosar       | La gran cara peluda de Hagrid rebosaba alegría sobre el mar de cabezas.
tientas       | tienta        | Resbalando y a tientas, siguieron a Hagrid por lo que parecía un empinado y estrecho sendero.
empinado      | empinado      | Resbalando y a tientas, siguieron a Hagrid por lo que parecía un empinado y estrecho sendero.
tupidos       | tupido        | Estaba tan oscuro que Harry pensó que debía de haber árboles muy tupidos a ambos lados.
risco         | risco         | Todos estaban en silencio, contemplando el gran castillo que se elevaba sobre sus cabezas mientras se acercaban cada vez más al risco donde se erigía.
erigía        | erigirse      | Todos estaban en silencio, contemplando el gran castillo que se elevaba sobre sus cabezas mientras se acercaban cada vez más al risco donde se erigía.
hiedra        | hiedra        | Todos agacharon la cabeza y los botecitos los llevaron a través de una cortina de hiedra, que escondía una ancha abertura en la parte delantera del peñasco.
guijarros     | guijarro      | Fueron por un túnel oscuro que parecía conducirlos justo por debajo del castillo, hasta que llegaron a una especie de muelle subterráneo, donde treparon entre las rocas y los guijarros.
pasadizo      | pasadizo      | Luego subieron por un pasadizo en la roca, detrás de la lámpara de Hagrid, saliendo finalmente a un césped suave y húmedo, a la sombra del castillo.
