puño         | puño
rezongó      | rezongar
picado       | picado
manojos      | manojo
babosas      | babosa
cordel       | cordel
puñado       | puñado
soñoliento   | soñoliento
desperezó    | desperezarse
duendes      | duende
irguió       | erguirse
lástima      | lástima
chapucero    | chapucero
muelle       | muelle
transeúntes  | transeúnte
jadeando     | jadear
correteaba   | corretear
puntiagudo   | puntiagudo
broches      | broche
reglamentario| reglamentario
hongos       | hongo
Filtros      | filtro
redomas      | redoma
estropeada   | estropeado
muchedumbre  | muchedumbre
Chorreante   | chorrear
mugriento    | mugriento
reparado     | reparar
destartalado | destartalado
jerez        | jerez
nuez         | nuez
barullo      | barullo
torbellino   | torbellino
botica       | botica
murciélago   | murciélago
codicia      | codicia
centenar     | centenar
escocían     | escocer
ráfagas      | ráfaga
estallido    | estallido
estruendo    | estruendo
oleada       | oleada
montículos   | montículo
recodos      | recodo
sacudidas    | sacudida
barranco     | barranco
costado      | costado
succionado   | succionar
deslizó      | deslizar
fastidiar    | fastidiar
emborracha   | emborracharse
frambuesa    | frambuesa
forrados     | forrado
venganzas    | venganza
macizo       | macizo
hedor        | hedor
podrido      | podrido
viscosa      | viscoso
hileras      | hilera
colmillos    | colmillo
surtido      | surtido
cucharada    | cucharada
ruborizaba   | ruborizar
aleteos      | aleteo
aspereza     | aspereza
cojín        | cojín
desteñido    | desteñido
endeble      | endeble
comezón      | comezón
picara       | picar
torpeza      | torpeza
sauce        | sauce
caoba        | caoba
velados      | velado
Roble        | roble
vivacidad    | vivacidad
sequedad     | sequedad
agarraba     | agarrar
axila        | axila
fosas        | fosa
revoloteando | revolotear
haya         | haya
Arce         | arce
Ébano        | ébano
acebo        | acebo
chispas      | chispa
vitoreó      | vitorear
enmarañada   | enmarañado
espesas      | espeso
