antojo        | antojo
desplazamiento| desplazamiento
alfombras     | alfombra
tejanos       | tejanos
perversa      | perverso
taquilla      | taquilla
pelirroja     | pelirrojo
quieta        | quieto
pecoso        | pecoso
desvió        | desviar
listón        | listón
revoltosos    | revoltoso
enrojecieron  | enrojecer
bufó          | bufar
traqueteo     | traqueteo
hoyuelos      | hoyuelo
golosinas     | golosina
chicles       | chicle
empanada      | empanada
regaliz       | regaliz
mordisco      | mordisco
envase        | envase
cromo         | cromo
suelto        | suelto
grageas       | gragea
callos        | callos
Coles         | col
judías        | judía
agreste       | agreste
gimió         | gemir
astillada     | astillar
mandona       | mandón
aturdido      | aturdido
abrumado      | abrumado
enteraste     | enterarse
punzada       | punzada
pecas         | peca
indebida      | indebido
gentuza       | gentuza
desprenderse  | desprenderse
desmayado     | desmayarse
chiquilladas  | chiquillada
retumbó       | retumbar
rebosaba      | rebosar
pisáis        | pisar
tientas       | tienta
empinado      | empinado
tupidos       | tupido
risco         | risco
erigía        | erigirse
peñasco       | peñasco
hiedra        | hiedra
guijarros     | guijarro
pasadizo      | pasadizo
