repisa         | repisa
gorros         | gorro
tiovivo        | tiovivo
roce           | roce
fogón          | fogón
refunfuñó      | refunfuñar
alacena        | alacena
recibidor      | recibidor
aborrecía      | aborrecer
conllevaba     | conllevar
prendas        | prenda
huesudas       | huesudo
bramó          | bramar
acuoso         | acuoso
gruesa         | grueso
ensombreció    | ensombrecerse
volcaba        | volcar
pichoncito     | pichón
dulzura        | dulzor
desembalando   | desembalar
envoltorio     | envoltorio
manzanas       | manzana
repollo        | repollo
gusano         | gusano
rezongó        | rezongar
retorcía       | retorcer
sollozos       | sollozo
burlona        | burlón
flacucho       | flacucho
rape           | rape
exceptuando    | exceptuar
flequillo      | flequillo
holgada        | holgado
manchas        | mancha
encogido       | encogerse
tejado         | tejado
amenazadora    | amenazador
trepando       | trepar
gamberros      | gamberro
remolacha      | remolacha
disimuladamente| disimuladamente
desagradaba    | desagradar
polo           | polo
rascaba        | rascarse
rabieta        | rabieta
vidrieras      | vidriera
lagartos       | lagarto
estrujaban     | estrujar
nudillos       | nudillo
dormitando     | dormitar
ojillos        | ojillos
Guiñó          | guiñar
ensordecedor   | ensordecedor
contoneándose  | contonearse
incorporó      | incorporarse
desenrollado   | desenrollarse
conmocionado   | conmocionado
trasero        | trasero
desplomarse    | desplomarse
desgraciados   | desgraciado
estrafalario   | estrafalario
estrechado     | estrechar
