rollizo      | rollizo
bigote       | bigote
estirándolo  | estirar
estremecían  | estremecerse
juntara      | juntarse
sombrío      | sombrío
parloteaba   | parlotear
ruidoso      | ruidoso
trona        | trona
pardo        | pardo
berrinche    | berrinche
Pillastre    | pillastre
atigrado     | atigrado
parpadeó     | parpadear
rótulo       | rótulo
negó         | negar
apartó       | apartar
advertir     | advertir
conjuntos    | conjunto
Tamborileó   | tamborilear
Cuchicheaban | cuchichear
enfureció    | enfurecerse
incluso      | incluso
valor        | valor
desfilaban   | desfilar
susurraba    | susurrar
hucha        | hucha
contuvo      | contenerse
apresuró     | apresurarse
marcar       | marcar
atusó        | atusarse
trastornaba  | trastornarse
reprochárselo| reprochar
gruñó        | gruñir
tambaleaba   | tambalearse
rostro       | rostro
chillona     | chillón
Contigua     | contiguo
Pese         | pese
mueca        | mueca
chaparrón    | chaparrón
Hogueras     | hoguera
cuchicheo    | cuchicheo
masculló     | mascullar
fruncidos    | fruncir
espantosa    | espantoso
abatimiento  | abatimiento
escudriñó    | escudriñar
Bostezó      | bostezar
adormecerse  | adormecerse
pestañear    | pestañear
súbita       | súbito
surgido      | surgir
entornaron   | entornar
plateados    | plateado
túnica       | túnica
púrpura      | púrpura
hebillas     | hebilla
centelleaban | centellear
revolviendo  | revolver
encendedor   | encendedor
sostuvo      | sostener
estallido    | estallido
lejanos      | lejano
cuentas      | cuenta
montura      | montura
cuadrada     | cuadrado
cabello      | cabello
tieso        | tieso
ladrillo     | ladrillo
resopló      | resoplar
Torció       | torcer
Bandadas     | bandada
afable       | afable
soslayo      | soslayo
frialdad     | frialdad
sensata      | sensato
desenvolver  | desenvolver
ruborizaba   | ruborizarse
tapia        | tapia
asintió      | asentir
apesadumbrado| apesadumbrado
tartamudeó   | tartamudear
puntilla     | puntilla
manecillas   | manecilla
patadas      | patada
regañadientes| regañadientes
calzada      | calzada
desaliñado   | desaliñado
revuelto     | revuelto
bulto        | bulto
mantas       | manta
aliviado     | aliviado
mata         | mata
azabache     | azabache
desgreñada   | desgreñado
raspándolo   | raspar
siseó        | sisear
lloriqueó    | lloriquear
domínate     | dominarse
verja        | verja
umbral       | umbral
titilante    | titilante
irradiaban   | irradiar
ronca        | ronco
palanca      | palanca
estrépito    | estrépito
sonó         | sonarse
escabullía   | escabullirse
pulcros      | pulcro
setos        | seto
tinta        | tinta
pinchado     | pinchar
pellizcado   | pellizcar
quedas       | quedo
