crujido         | crujido
goznes          | gozne
maraña          | maraña
escarabajos     | escarabajo
pelambrera      | pelambrera
escurrió        | escurrirse
desparramó      | desparramarse
agazapada       | agazaparse
peludo          | peludo
allanamiento    | allanamiento
morada          | morada
majadero        | majadero
arrebató        | arrebatar
pisarlo         | pisar
pegajoso        | pegajoso
sacudió         | sacudir
clavaron        | clavarse
parpadeante     | parpadeante
hundió          | hundirse
salchichas      | salchicha
agrietadas      | agrietado
trago           | trago
chisporroteantes| chisporrotear
grasientas      | grasiento
hambriento      | hambriento
sorbo           | sorbo
dorso           | dorso
impresionado    | impresionado
retrocedieron   | retroceder
acobardado      | acobardarse
aterrado        | aterrar
silbido         | silbido
entrecortada    | entrecortado
HECHICERÍA      | hechicería
Hechicero       | hechicero
erizadas        | erizado
ceniza          | ceniza
monstruosidad   | monstruosidad
ultraje         | ultraje
apremio         | apremio
apoderando      | apoderarse
opusieron       | oponerse
corneta         | corneta
sarta           | sarta
disparates      | disparate
respingo        | respingo
paliza          | paliza
alanceado       | alancear
empuñado        | empuñar
esfumó          | esfumarse
complacido      | complacido
sapos           | sapo
derrotó         | derrotar
varitas         | varita
CHIFLADO        | chiflado
silbó           | silbar
rizada          | rizado
reojo           | reojo
cejas           | ceja
lirones         | lirón
